111111111
1C0P1C0C1
100110001
100000001
1000R0001
100000001
100011001
100C1E001
111111111
