1111111111111
11111P1111101
100EC01000101
10111010R0001
1010000001101
1000111100001
1010111100111
1010011000001
1001011111001
1111000001001
1111111111111
