   111  111
   10111101
11110000001
1010111101111111
10001 1000000001
10001 1000111111
11111 11111
