111111111111
10000P100101
101111100C01
1C1000001101
100011110001
101011110111
1010011C0001
10C101111101
11110000C1E1
111111111111
