1111111111
1000000001
10P0000C01
1000000001
10C01100C1
1000110001
1000000001
10000C0001
10000000E1
1111111111
