11111
1P0E1
1CCC1
10001
11111
