111111111111
100000100101
10P101000C01
101000001001
10C0111100C1
100011110001
100001100001
10000C110001
1110000000E1
111111111111
